.  .  .  .  G
.  .  .  .  .
.  .  .  .  .
x  x  .  x  x
.  .  .  .  G
.  .  .  .  .
.  .  .  .  .