x x x x x x x x x x x 
x . . . . . . . . G x
x . . . x . . . . G x
x . . . x . . . . G x
x . . . x . . . . G x
x . . . . . . . . G x
x . . . x . . . . G x
x . . . x . . . . G x
x . . . x . . . . G x
x . . . . . . . . G x
x x x x x x x x x x x 